00000000000000000000000000000000
00011111111111100111111111111000
00010000100000100100001000001000
00010000100000100100001000001000
00010000100000100100001000001000
00011111111111111111111111111000
00010000100100000000100100001000
00010000100100000000100100001000
00011111100111100111100111111000
00000000100000200200000100000000
00000000100000200200000100000000
00000000100222222222200100000000
00000000100200033000200100000000
00000000100203333330200100000000
00000000100203333330200100000000
44422222122203333330222122222444
00000000100203333330200100000000
00000000100200000000200100000000
00000000100222222222200100000000
00000000100200000000200100000000
00000000100200000000200100000000
00011111111111100111111111111000
00010000100000100100000100001000
00010000100000100100000100001000
00011100111111199111111100111000
00000100100100000000100100100000
00000100100100000000100100100000
00011111100111100111100111111000
00010000000000100100000000001000
00010000000000100100000000001000
00011111111111111111111111111000
00000000000000000000000000000000